22 40
100 100
2 2 2 2 2 2 2 2 2 0 0 0 0 0 0 0 0 0 0 0 0 0
2 4 4 4 4 4 2 5 2 4 4 4 4 4 4 4 4 4 4 4 4 0
2 4 4 4 4 4 2 5 2 4 4 4 4 4 4 4 4 4 4 4 4 0
2 4 4 4 4 4 2 5 2 2 4 2 2 2 2 3 3 3 3 4 3 0
2 4 4 4 4 4 2 5 2 4 4 4 4 4 2 0 4 4 4 4 4 0
2 2 2 4 2 2 2 5 2 4 4 4 4 4 2 0 4 4 4 4 4 0
2 4 4 4 4 4 2 5 2 2 2 2 2 4 2 0 4 4 4 4 4 0
2 4 4 4 4 4 2 5 2 4 4 4 4 4 2 0 4 4 4 4 4 0
2 2 4 2 2 2 2 5 2 4 4 4 4 4 2 0 4 4 4 4 4 0
2 4 4 4 4 4 2 5 2 4 2 2 2 2 2 0 4 4 4 4 4 0
2 4 4 4 4 4 2 5 2 4 4 4 4 4 2 0 4 4 4 4 4 0
2 2 2 4 4 4 2 5 2 4 4 4 4 4 2 0 4 4 4 4 4 0
2 4 4 4 4 4 2 5 2 2 2 2 2 4 2 0 4 4 4 4 4 0
2 4 4 4 4 4 2 5 2 4 4 4 4 4 2 0 4 4 4 4 4 0
2 2 2 2 2 4 2 5 2 4 4 4 4 4 2 0 4 4 4 4 4 0
2 4 4 4 4 4 2 5 2 4 2 2 2 2 2 0 4 4 4 4 4 0
2 4 4 4 4 4 2 5 2 4 4 4 4 4 2 0 4 4 4 4 4 0
2 2 4 2 2 2 2 5 2 4 4 4 4 4 2 0 4 4 4 4 4 0
2 4 4 4 4 4 2 5 2 2 2 2 2 4 2 0 4 4 4 4 4 0
2 4 4 4 4 4 2 5 2 4 4 4 4 4 2 0 4 4 4 4 4 0
2 2 2 2 4 2 2 5 2 4 4 4 4 4 2 0 4 4 4 4 4 0
2 4 4 4 4 4 2 5 2 2 4 2 2 2 2 0 4 4 4 4 4 0
2 4 4 4 4 4 2 5 2 4 4 4 4 4 2 0 4 4 4 4 4 0
2 2 4 2 2 2 2 5 2 4 4 4 4 4 2 0 4 4 4 4 4 0
2 4 4 4 4 4 2 5 2 2 4 2 2 2 2 0 4 4 4 4 4 0
2 4 4 4 4 4 2 5 2 4 4 4 4 4 2 0 4 4 4 4 4 0
2 2 2 4 2 2 2 5 2 4 4 4 4 4 2 0 4 4 4 4 4 0
2 4 4 4 4 4 2 5 2 2 2 2 2 4 2 0 4 4 4 4 4 0
2 4 4 4 4 4 2 5 2 4 4 4 4 4 2 0 4 4 4 4 4 0
2 2 2 4 2 2 2 5 2 4 4 4 4 4 2 0 4 4 4 4 4 0
2 4 4 4 4 4 2 5 2 2 4 2 2 2 2 0 4 4 4 4 4 0
2 4 4 4 4 4 2 5 2 4 4 4 4 4 2 0 4 4 4 4 4 0
2 4 2 2 2 2 2 5 2 4 4 4 4 4 2 0 4 4 4 4 4 0
2 4 4 4 4 4 2 5 2 2 2 2 4 2 2 0 4 4 4 4 4 0
2 2 2 2 2 4 2 5 2 4 4 4 4 4 2 0 4 4 4 4 4 0
2 4 4 4 4 4 2 5 2 4 4 4 4 4 2 0 4 4 4 4 4 0
2 4 4 4 4 4 2 2 2 2 2 2 4 2 2 0 4 4 4 4 4 0
2 4 4 4 4 4 4 4 4 4 4 4 4 4 4 0 4 4 4 4 4 0
2 4 4 4 4 4 4 4 4 4 4 4 4 4 4 0 4 4 4 4 4 0
2 2 2 2 2 2 2 5 2 2 2 2 2 2 0 4 4 4 4 4 4 0 