40 16
100 100
2 4 4 4 4 4 4 4 4 4 4 4 4 4 4 4 4 4 4 4 4 4 4 4 4 4 4 4 4 4 4 4 4 4 4 4 4 4 4 4
2 4 4 4 4 4 4 4 4 4 4 4 4 4 4 4 4 4 4 4 4 4 4 4 4 4 4 4 4 4 4 4 4 4 4 4 4 4 4 4
2 4 4 4 4 4 4 4 4 4 4 4 4 4 4 4 4 4 4 4 4 4 4 4 4 4 4 1 4 4 4 4 4 4 4 4 4 4 4 4
2 4 4 4 4 4 4 4 4 4 4 4 4 4 4 4 4 4 4 4 4 4 4 4 4 4 1 4 4 4 4 4 4 4 4 4 4 4 4 4
2 4 4 4 4 4 4 4 4 4 4 4 4 4 4 4 4 4 4 4 4 4 4 4 4 1 4 1 1 1 1 5 5 1 1 4 4 4 4 4
2 4 4 4 4 4 2 2 2 4 4 4 4 4 4 4 1 4 4 4 4 4 4 4 1 4 4 4 4 4 4 2 2 4 1 1 1 1 4 1
2 4 4 4 4 4 2 2 2 4 4 4 4 4 4 4 1 4 4 4 4 4 4 1 4 4 4 4 4 4 4 4 4 4 4 4 4 4 4 4
2 4 4 4 4 4 2 2 2 4 4 4 4 4 4 4 1 4 4 4 4 4 1 4 4 4 4 4 4 4 4 4 4 4 4 4 4 4 4 4
2 1 1 4 4 1 1 1 1 1 4 1 1 4 4 4 1 1 1 1 1 4 4 1 4 1 1 1 1 1 1 1 1 1 1 4 4 4 4 4
2 1 1 1 4 4 1 1 1 1 1 1 1 1 4 4 4 4 4 4 4 4 1 1 4 4 4 4 4 4 1 1 1 1 1 1 4 4 4 4
2 4 4 4 4 4 4 4 4 1 1 1 1 1 1 4 4 4 4 4 4 1 1 1 1 1 1 1 4 4 1 1 1 1 1 1 1 4 4 4
2 4 4 1 2 2 2 2 2 1 1 1 1 1 1 1 4 4 4 4 1 1 1 1 4 4 4 4 4 4 2 4 4 4 4 4 1 4 4 4
2 1 4 1 1 1 1 1 1 1 1 1 1 1 1 1 1 1 1 1 1 1 1 1 4 4 4 2 2 2 2 4 4 4 4 4 1 4 4 2
2 4 4 4 4 4 1 1 1 1 1 1 1 1 1 1 1 1 1 1 1 1 1 1 2 4 4 4 4 4 4 4 4 1 2 4 1 2 4 2
2 2 2 2 2 1 1 1 1 1 1 1 1 1 1 1 1 1 1 1 1 1 1 1 2 2 2 4 2 2 2 4 4 4 1 4 1 4 4 2
2 5 5 5 5 5 5 5 5 5 2 2 2 2 2 2 2 2 5 5 5 5 5 5 5 5 5 5 5 5 5 5 5 5 5 4 5 5 5 5