22 40
100 100
6 2 2 2 2 2 6 2 6 0 0 0 0 0 0 0 0 0 0 0 0 6
2 4 4 4 4 4 2 5 2 4 4 4 4 4 4 4 4 4 4 4 4 0
2 4 4 4 4 4 2 5 2 4 4 4 4 4 4 4 4 4 4 4 4 0
2 4 4 4 4 4 2 5 6 2 4 2 2 2 3 3 3 3 3 4 3 6
2 4 4 4 4 4 2 5 2 4 4 4 4 4 2 0 4 4 4 4 4 0
6 2 2 4 2 2 6 5 2 4 4 4 4 4 2 0 4 4 4 4 4 0
2 4 4 4 4 4 2 5 6 2 2 2 2 4 6 0 4 4 4 4 4 0
2 4 4 4 4 4 2 5 2 4 4 4 4 4 2 0 4 4 4 4 4 0
6 2 4 2 2 2 6 5 2 4 4 4 4 4 2 0 4 4 4 4 4 0
2 4 4 4 4 4 2 5 6 4 2 2 2 2 6 0 4 4 4 4 4 0
2 4 4 4 4 4 2 5 2 4 4 4 4 4 2 0 4 4 4 4 4 0
2 2 2 4 4 4 2 5 2 4 4 4 4 4 2 0 4 4 4 4 4 0
2 4 4 4 4 4 2 5 6 2 2 2 2 4 6 0 4 4 4 4 4 0
2 4 4 4 4 4 2 5 2 4 4 4 4 4 2 0 4 4 4 4 4 0
6 2 2 2 2 4 6 5 2 4 4 4 4 4 2 0 4 4 4 4 4 0
2 4 4 4 4 4 2 5 6 4 2 2 2 2 6 0 4 4 4 4 4 0
2 4 4 4 4 4 2 5 2 4 4 4 4 4 2 0 4 4 4 4 4 0
6 2 4 2 2 2 6 5 2 4 4 4 4 4 2 0 4 4 4 4 4 0
2 4 4 4 4 4 2 5 6 2 2 2 2 4 6 0 4 4 4 4 4 0
2 4 4 4 4 4 2 5 2 4 4 4 4 4 2 0 4 4 4 4 4 0
6 2 2 2 4 2 6 5 2 4 4 4 4 4 2 0 4 4 4 4 4 0
2 4 4 4 4 4 2 5 6 2 4 2 2 2 6 0 4 4 4 4 4 0
2 4 4 4 4 4 2 5 2 4 4 4 4 4 2 0 4 4 4 4 4 0
6 2 4 2 2 2 6 5 2 4 4 4 4 4 2 0 4 4 4 4 4 0
2 4 4 4 4 4 2 5 6 2 4 2 2 2 6 0 4 4 4 4 4 0
2 4 4 4 4 4 2 5 2 4 4 4 4 4 2 0 4 4 4 4 4 0
2 2 2 4 2 2 2 5 2 4 4 4 4 4 2 0 4 4 4 4 4 0
2 4 4 4 4 4 2 5 6 2 2 2 2 4 6 0 4 4 4 4 4 0
2 4 4 4 4 4 2 5 2 4 4 4 4 4 2 0 4 4 4 4 4 0
6 2 2 4 2 2 6 5 2 4 4 4 4 4 2 0 4 4 4 4 4 0
2 4 4 4 4 4 2 5 6 2 4 2 2 2 6 0 4 4 4 4 4 0
2 4 4 4 4 4 2 5 2 4 4 4 4 4 2 0 4 4 4 4 4 0
6 4 2 2 2 2 6 5 2 4 4 4 4 4 2 0 4 4 4 4 4 0
2 4 4 4 4 4 2 5 6 2 2 2 4 2 6 0 4 4 4 4 4 0
6 2 2 2 2 4 6 5 2 4 4 4 4 4 2 0 4 4 4 4 4 0
2 4 4 4 4 4 2 5 2 4 4 4 4 4 2 0 4 4 4 4 4 0
2 4 4 4 4 4 6 2 6 2 2 2 4 2 6 0 4 4 4 4 4 0
2 4 4 4 4 4 4 4 4 4 4 4 4 4 4 0 4 4 4 4 4 0
2 4 4 4 4 4 4 4 4 4 4 4 4 4 4 0 4 4 4 4 4 0
2 2 2 2 2 2 2 5 2 2 2 2 2 2 0 4 4 4 4 4 4 0 