40 16
100 100
2 4 4 4 4 4 4 4 4 4 4 4 4 4 4 4 4 4 4 4 4 4 4 4 4 4 4 4 4 4 4 4 4 4 4 4 4 4 4 4
2 4 4 4 4 4 4 4 4 4 4 4 4 4 4 4 4 4 4 4 4 4 4 4 4 4 4 4 4 4 4 4 4 4 4 4 4 4 4 4
2 4 4 4 4 4 4 4 4 4 4 4 4 4 4 4 4 4 4 4 4 4 4 4 4 4 4 4 4 4 4 4 4 4 4 4 4 4 4 4
2 4 4 4 4 4 4 4 4 4 4 4 4 4 4 4 4 4 4 4 4 4 4 4 4 4 4 4 4 4 4 4 4 4 4 4 4 4 4 4
2 4 4 4 4 4 4 4 4 4 4 4 4 4 4 4 4 4 4 4 4 4 4 4 4 4 4 1 1 1 4 4 4 1 1 4 4 4 4 4
2 4 4 4 4 4 2 2 2 4 4 4 4 4 4 4 4 4 4 4 4 4 4 4 1 4 4 4 4 4 4 4 4 4 1 1 1 1 4 1
2 4 4 4 4 4 2 2 2 4 4 4 4 4 4 4 4 4 4 4 4 4 4 1 4 4 4 4 4 4 4 4 4 4 4 4 4 4 4 4
2 4 4 4 4 4 2 2 2 4 4 4 4 4 4 4 4 4 4 4 4 4 1 4 4 4 4 4 4 4 4 4 4 4 4 4 4 4 4 4
2 1 1 4 4 1 1 1 1 1 4 1 3 4 4 4 1 1 1 1 1 4 4 3 1 1 1 4 4 1 1 1 1 1 1 4 4 4 4 4
2 1 1 1 4 4 1 1 1 1 1 1 1 3 4 4 4 4 4 4 4 4 3 3 1 1 1 4 4 4 1 1 1 1 1 1 4 4 4 4
2 4 4 4 4 4 4 4 4 1 1 1 1 1 3 4 4 4 4 4 4 3 1 1 1 1 1 1 4 4 1 1 1 1 1 1 1 4 4 4
2 4 4 1 2 2 2 2 2 1 1 1 1 1 1 3 4 4 4 4 3 3 1 1 4 4 4 4 4 4 4 4 4 4 4 4 1 4 4 4
2 1 4 1 1 1 1 1 1 1 1 1 1 1 1 1 3 3 3 3 1 1 1 1 4 4 4 4 4 4 4 4 4 4 4 4 1 4 4 2
2 4 4 4 4 4 1 1 1 1 1 1 1 1 1 1 1 1 1 1 1 1 1 1 2 4 4 4 4 4 4 4 4 4 2 2 1 4 4 2
2 2 2 2 2 1 1 1 1 1 1 1 1 1 1 1 1 1 1 1 1 1 1 1 2 2 2 2 2 2 2 4 4 4 1 1 1 4 4 2
2 5 5 5 5 5 5 5 5 5 5 5 5 5 5 5 5 5 5 5 5 5 5 5 5 5 5 5 5 5 5 5 5 5 5 5 5 5 5 5